1111111111
1P11010001
1011011101
100C011001
1111010011
1111010111
11110000E1
1111111111
